###########################           
#.........................#           
#.........................############
# P..................................#
#..................................C.#
#....................................#
#.........................############
#.........................#           
###########################           