###########################___________
#.........................#___________
#.........................############
#.P..................................#
#..................................C.#
#....................................#
#.........................############
#.........................#___________
###########################___________