########################################
#...#...##.............................#
#.P.....##.............................#
#.......##..######..#################..#
#...#.......######..##..............#..#
#####.......##..##..##..............#..#
######..##########..##..##########..#..#
#...##..#...##..##......#...##..##..#..#
#...##..#...##..##......#...##..##..#..#
##..##..##..##..##..##..#...........#..#
##......##..##..#...##..##..........#..#
##......##..##..#...######..##..##..#..#
##..######..######..##..##..#########..#
##..######..##..##..##..##......##..#..#
##..##..##..##..##..##..##......##..#..#
##..##..##..##..##..##..##..##..##..#..#
##..##..##..##..######..##..##..##..#..#
##..##..##..##..##......##..##..##..#..#
##..##..##..##..##......##..##..##..#..#
##..##......##..##..##..##..##..##..#..#
##..##......##..##..##..##..##..##..#..#
##..##..##..##..##..##..##..##..##..#..#
##..##..##..##..##..##..######..##..#..#
##..##..##..##..##..##..##......##..#..#
##..##..##..##..##..##..##......##..#..#
##..##..##..##..##..##......######..#..#
##..##..##..##..##..##......##......#..#
##..##..##..##..##..##########......#..#
##..##..##..##..##..##..##..##..##..#..#
##......##..##..##..##......##..##..#..#
##......##......##..##......##..##..#..#
##..##..##......##..##..##..##..##..#..#
##..##..##..##..##..##..##..##..##..#..#
##..##..##..##..##......##..##..##..#..#
##..##..##..##..##......##..##..##..#..#
##..##..##..##..##..##..##..##..##..####
##..##..##..##..##..##..##..##..##.....#
##..##..##..##..##..##..##......##...B.#
##..##..##..##..##..##..##......##.....#
########################################