####################################################################
#..................................................................#
#.P................................................................#
#..................................................................#
################################################################...#
_______________________________________________________________#...#
_______________________________________________________________#...#
_______________________________________________________________#...#
_______________________________________________________________#...#
_______________________________________________________________#...#
_______________________________________________________________#...#
_______________________________________________________________#...#
_______________________________________________________________#.S.#
_______________________________________________________________#####