###########################__________________________________________________
#.........................#__________________________________________________
#.........................############_______________________________________
#.P..................................##############################__________
#.................................................................#__________
#....................................############################.#__________
#.........................######.#####__________________________#.#__________
#.........................#____#.#_____________________________##.##_________
################################.#_____________________________#...#_________
#................................#_____________________________#...#_________
#.################################_____________________________#...#_________
#.#...#.........#.#...#.#.....#________________________________#####_________
#.#.#.###.#####.###.#.###.#.#.#______________________________________________
#...#.#.#.#...#.....#.....#.#.#______________________________________________
#.###.#.#.#.###.###.#####.#.#.#______________________________________________
#.#.#.#.#.#.#...#.#.....#.#...#______________________________________________
#.#.#.#.#####.###.###.###.#.###______________________________________________
#.#.#.......#.#...#...#...#...#______________________________________________
#.#.#####.###.#####.###.###.#.#______________________________________________
#.#...#.#.#.#...#...#.#.....#.#______________________________________________
#.###.#.#.#.###.###.#.#.###.#.#______________________________________________
#.#...#.#.....#.#.#...#.#...#.#__############################################
#.###.###.###.#.#.#.###.#.#.#.####..#.......................................#
#.#...#...#.....#...#.#...#.#.......C.......................................#
##################################..#.......................................#
_________________________________############################################