###################################################################################################
###################################################################################################
#####                                            L                                            #####
#####                                         1  L                                            #####
#####                                         2  L                                            #####
#####                                            L                                            #####
#####    #################################################################################    #####
#####    #################################################################################    #####
#####    #################################################################################    #####
#####    #################################################################################    #####
#####    #################################################################################    #####
#####    #################################################################################    #####
#####    #################################################################################    #####
#####    #################################################################################    #####
#####    #################################################################################    #####
#####    #################################################################################    #####
#####    #################################################################################    #####
#####    #################################################################################    #####
#####    #################################################################################    #####
#####    #################################################################################    #####
#####    #################################################################################    #####
#####    #################################################################################    #####
#####    #################################################################################    #####
#####    #################################################################################    #####
#####    #################################################################################    #####
#####    #################################################################################    #####
#####    #################################################################################    #####
#####    #################################################################################    #####
#####    #################################################################################    #####
#####    #################################################################################    #####
#####    #################################################################################    #####
#####    #################################################################################    #####
#####    #################################################################################    #####
#####    #################################################################################    #####
#####    #################################################################################    #####
#####    #################################################################################    #####
#####    #################################################################################    #####
#####    #################################################################################    #####
#####    #################################################################################    #####
#####    #################################################################################    #####
#####    #################################################################################    #####
#####    #################################################################################    #####
#####    #################################################################################    #####
#####    #################################################################################    #####
#####                                           C                                             #####
#####                                           C                                             #####
#####                                           C                                             #####
#####                                           C                                             #####
###################################################################################################
###################################################################################################